{
 "name": "Level 6",
 "elements": [
    "1",
    "2",
    "3"
    ],
 "spoilt": [],
 "locked": [],
 "figure_max_size": 3,
 "bg_image": "bg1.jpg",
 "grid_border": "grid_border1.png",
 "field": 
    [["0", "0", "0", "o", "e", "o", "0", "0", "0", "o", "e", "o", "0", "0", "0"],
    ["0", "0", "0", "o", "e", "o", "0", "0", "0", "o", "e", "o", "0", "0", "0"],
    ["0", "0", "0", "o", "e", "o", "0", "0", "0", "o", "e", "o", "0", "0", "0"],
    ["o", "o", "o", "o", "e", "o", "0", "0", "0", "o", "e", "o", "o", "o", "o"],
    ["e", "e", "e", "e", "e", "o", "0", "0", "0", "o", "e", "e", "e", "e", "e"],
    ["o", "o", "o", "o", "o", "o", "0", "0", "0", "o", "o", "o", "o", "o", "o"],
    ["0", "0", "0", "0", "0", "0", "0", "0", "0", "0", "0", "0", "0", "0", "0"],
    ["0", "0", "0", "0", "0", "0", "0", "0", "0", "0", "0", "0", "0", "0", "0"],
    ["0", "0", "0", "0", "0", "0", "0", "0", "0", "0", "0", "0", "0", "0", "0"],
    ["o", "o", "o", "o", "o", "o", "0", "0", "0", "o", "o", "o", "o", "o", "o"],
    ["e", "e", "e", "e", "e", "o", "0", "0", "0", "o", "e", "e", "e", "e", "e"],
    ["o", "o", "o", "o", "e", "o", "0", "0", "0", "o", "e", "o", "o", "o", "o"],
    ["0", "0", "0", "o", "e", "o", "0", "0", "0", "o", "e", "o", "0", "0", "0"],
    ["0", "0", "0", "o", "e", "o", "0", "0", "0", "o", "e", "o", "0", "0", "0"],
    ["0", "0", "0", "o", "e", "o", "0", "0", "0", "o", "e", "o", "0", "0", "0"]],
 "goal": {
    "1": 5,
    "2": 5,
    "3": 5
    },
 "research": "sulphur"
}
