{
 "name": "Level 2",
 "elements": [
    "1",
    "2",
    "3",
    "4"
    ],
 "spoilt": [
    "1"
    ],
 "locked": [
    "4"
    ],
 "figure_max_size": 3,
 "bg_image": "bg1.jpg",
 "field": 
    [["3", "0", "3", "0", "3", "0", "3", "0", "3", "0", "3", "0", "3", "0", "3"],
    ["0", "3", "0", "3", "0", "3", "0", "3", "0", "3", "0", "3", "0", "3", "0"],
    ["0", "0", "0", "0", "0", "0", "0", "0", "0", "0", "0", "0", "0", "0", "0"],
    ["0", "0", "0", "0", "0", "0", "0", "0", "0", "0", "0", "0", "0", "0", "0"],
    ["0", "0", "0", "0", "0", "0", "0", "0", "0", "0", "0", "0", "0", "0", "0"],
    ["0", "0", "0", "0", "0", "0", "0", "0", "0", "0", "0", "0", "0", "0", "0"],
    ["0", "0", "0", "0", "0", "0", "4", "1", "4", "0", "0", "0", "0", "0", "0"],
    ["0", "0", "0", "0", "0", "0", "1", "4", "1", "0", "0", "0", "0", "0", "0"],
    ["0", "0", "0", "0", "0", "0", "4", "1", "4", "0", "0", "0", "0", "0", "0"],
    ["0", "0", "0", "0", "0", "0", "0", "0", "0", "0", "0", "0", "0", "0", "0"],
    ["0", "0", "0", "0", "0", "0", "0", "0", "0", "0", "0", "0", "0", "0", "0"],
    ["0", "0", "0", "0", "0", "0", "0", "0", "0", "0", "0", "0", "0", "0", "0"],
    ["0", "0", "0", "0", "0", "0", "0", "0", "0", "0", "0", "0", "0", "0", "0"],
    ["0", "3", "0", "3", "0", "3", "0", "3", "0", "3", "0", "3", "0", "3", "0"],
    ["3", "0", "3", "0", "3", "0", "3", "0", "3", "0", "3", "0", "3", "0", "3"]],
 "goal": {
    "1": 5,
    "2": 5,
    "3": 5,
    "4": 5
    }
}
