{
 "name": "Level 1",
 "elements": [
    "1",
    "2",
    "3"
    ],
 "spoilt": [],
 "locked": [],
 "figure_max_size": 3,
 "bg_image": "bg1.jpg",
 "grid_border": "grid_border.png",
 "field": 
    [["0", "1", "0", "1", "0", "1", "0", "1", "0", "1", "0", "1", "0", "1", "0"],
    ["1", "0", "1", "0", "1", "0", "1", "0", "1", "0", "1", "0", "1", "0", "1"],
    ["0", "0", "0", "0", "0", "0", "0", "0", "0", "0", "0", "0", "0", "0", "0"],
    ["2", "0", "2", "0", "2", "0", "2", "0", "2", "0", "2", "0", "2", "0", "2"],
    ["3", "0", "0", "0", "0", "0", "0", "0", "0", "0", "0", "0", "0", "0", "3"],
    ["b", "3", "0", "0", "0", "0", "0", "0", "0", "0", "0", "0", "0", "3", "b"],
    ["b", "b", "3", "0", "0", "0", "0", "0", "0", "0", "0", "0", "3", "b", "b"],
    ["b", "b", "b", "3", "0", "0", "0", "0", "0", "0", "0", "3", "b", "b", "b"],
    ["b", "b", "3", "0", "0", "0", "0", "0", "0", "0", "0", "0", "3", "b", "b"],
    ["b", "3", "0", "0", "0", "0", "0", "0", "0", "0", "0", "0", "0", "3", "b"],
    ["3", "0", "0", "0", "0", "0", "0", "0", "0", "0", "0", "0", "0", "0", "3"],
    ["2", "0", "2", "0", "2", "0", "2", "0", "2", "0", "2", "0", "2", "0", "2"],
    ["0", "0", "0", "0", "0", "0", "0", "0", "0", "0", "0", "0", "0", "0", "0"],
    ["1", "0", "1", "0", "1", "0", "1", "0", "1", "0", "1", "0", "1", "0", "1"],
    ["0", "1", "0", "1", "0", "1", "0", "1", "0", "1", "0", "1", "0", "1", "0"]],
 "goal": {
    "1": 5,
    "2": 5,
    "3": 5
    },
 "research": "sulphur"
}
