{
 "name": "Level 4",
 "elements": [
    "1",
    "2",
    "3",
    "4"
    ],
 "spoilt": [
    "1"
    ],
 "locked": [
    "4"
    ],
 "figure_max_size": 4,
 "bg_image": "bg1.jpg",
 "grid_border": "grid_border.png",
 "field": 
    [["4", "b", "0", "0", "0", "0", "0", "0", "0", "0", "0", "0", "0", "b", "4"],
    ["b", "4", "b", "0", "0", "0", "0", "0", "0", "0", "0", "0", "b", "4", "b"],
    ["0", "b", "4", "b", "0", "0", "0", "0", "0", "0", "0", "b", "4", "b", "0"],
    ["0", "0", "b", "4", "b", "0", "0", "0", "0", "0", "b", "4", "b", "0", "0"],
    ["0", "0", "0", "b", "4", "b", "0", "0", "0", "b", "4", "b", "0", "0", "0"],
    ["0", "0", "0", "0", "b", "4", "b", "0", "b", "4", "b", "0", "0", "0", "0"],
    ["0", "0", "0", "0", "0", "b", "4", "1", "4", "b", "0", "0", "0", "0", "0"],
    ["0", "0", "0", "0", "0", "0", "1", "4", "1", "0", "0", "0", "0", "0", "0"],
    ["0", "0", "0", "0", "0", "b", "4", "1", "4", "b", "0", "0", "0", "0", "0"],
    ["0", "0", "0", "0", "b", "4", "b", "0", "b", "4", "b", "0", "0", "0", "0"],
    ["0", "0", "0", "b", "4", "b", "0", "0", "0", "b", "4", "b", "0", "0", "0"],
    ["0", "0", "b", "4", "b", "0", "0", "0", "0", "0", "b", "4", "b", "0", "0"],
    ["0", "b", "4", "b", "0", "0", "0", "0", "0", "0", "0", "b", "4", "b", "0"],
    ["b", "4", "b", "0", "0", "0", "0", "0", "0", "0", "0", "0", "b", "4", "b"],
    ["4", "b", "0", "0", "0", "0", "0", "0", "0", "0", "0", "0", "0", "b", "4"]],
 "goal": {
    "1": 5,
    "2": 5,
    "3": 5,
    "4": 5
    }
}
