{
 "name": "Level 4",
 "elements": [
    "1",
    "2",
    "3",
    "4"
    ],
 "spoilt": [
    "1"
    ],
 "locked": [
    "4"
    ],
 "figure_max_size": 4,
 "bg_image": "bg1.jpg",
 "field": 
    [["1", "4", "0", "0", "b", "b", "b", "b", "b", "b", "b", "0", "0", "4", "2"],
    ["4", "1", "0", "0", "b", "b", "b", "b", "b", "b", "b", "0", "0", "2", "4"],
    ["0", "0", "0", "0", "0", "0", "b", "b", "b", "0", "0", "0", "0", "0", "0"],
    ["0", "0", "0", "1", "4", "0", "0", "0", "0", "0", "4", "2", "0", "0", "0"],
    ["0", "0", "0", "4", "1", "0", "0", "0", "0", "0", "2", "4", "0", "0", "0"],
    ["0", "0", "0", "0", "0", "0", "0", "0", "0", "0", "0", "0", "0", "0", "0"],
    ["0", "0", "0", "0", "0", "0", "4", "1", "4", "0", "0", "0", "0", "0", "0"],
    ["3", "b", "3", "0", "0", "0", "2", "4", "2", "0", "0", "0", "3", "b", "3"],
    ["3", "b", "3", "0", "0", "0", "4", "1", "4", "0", "0", "0", "3", "b", "3"],
    ["0", "0", "0", "0", "0", "0", "0", "0", "0", "0", "0", "0", "0", "0", "0"],
    ["0", "0", "0", "4", "2", "0", "0", "0", "0", "0", "1", "4", "0", "0", "0"],
    ["0", "0", "0", "2", "4", "0", "0", "0", "0", "0", "4", "1", "0", "0", "0"],
    ["0", "0", "0", "0", "0", "0", "b", "b", "b", "0", "0", "0", "0", "0", "0"],
    ["4", "2", "0", "0", "b", "b", "b", "b", "b", "b", "b", "0", "0", "1", "4"],
    ["2", "4", "0", "0", "b", "b", "b", "b", "b", "b", "b", "0", "0", "4", "1"]],
 "goal": {
    "1": 10,
    "2": 10,
    "3": 10,
    "4": 10
    },
 "research": ""
}
