{
 "name": "Level 2",
 "elements": [
    "1",
    "2",
    "3"
    ],
 "spoilt": [],
 "locked": [],
 "figure_max_size": 3,
 "bg_image": "bg1.jpg",
 "field": 
    [["0", "2", "1", "0", "0", "0", "0", "0", "0", "0", "0", "0", "1", "3", "0"],
    ["0", "1", "3", "0", "0", "0", "0", "0", "0", "0", "0", "0", "2", "1", "0"],
    ["0", "2", "1", "0", "0", "0", "0", "0", "0", "0", "0", "0", "1", "3", "0"],
    ["0", "1", "3", "0", "0", "0", "0", "0", "0", "0", "0", "0", "2", "1", "0"],
    ["0", "2", "1", "0", "0", "0", "0", "b", "0", "0", "0", "0", "1", "3", "0"],
    ["0", "1", "3", "0", "0", "0", "b", "b", "b", "0", "0", "0", "2", "1", "0"],
    ["0", "2", "1", "0", "0", "b", "b", "b", "b", "b", "0", "0", "1", "3", "0"],
    ["0", "1", "3", "0", "b", "b", "b", "b", "b", "b", "b", "0", "2", "1", "0"],
    ["0", "2", "1", "0", "0", "b", "b", "b", "b", "b", "0", "0", "1", "3", "0"],
    ["0", "1", "3", "0", "0", "0", "b", "b", "b", "0", "0", "0", "2", "1", "0"],
    ["0", "2", "1", "0", "0", "0", "0", "b", "0", "0", "0", "0", "1", "3", "0"],
    ["0", "1", "3", "0", "0", "0", "0", "0", "0", "0", "0", "0", "2", "1", "0"],
    ["0", "2", "1", "0", "0", "0", "0", "0", "0", "0", "0", "0", "1", "3", "0"],
    ["0", "1", "3", "0", "0", "0", "0", "0", "0", "0", "0", "0", "2", "1", "0"],
    ["0", "2", "1", "0", "0", "0", "0", "0", "0", "0", "0", "0", "1", "3", "0"]],
 "goal": {
    "1": 10,
    "2": 10,
    "3": 10
    },
 "research": ""
}
