{
 "name": "Level 1",
 "elements": {
    "1": "mercury",
    "2": "saturn",
    "3": "jupiter",
    "4": "moon"
    },
 "locked": {
    "4": "moon"
    },
 "figure_max_size": 4,
 "bg_image": "bg1.jpg",
 "field": 
    [["3", "0", "0", "b", "0", "0", "0", "0", "0", "0", "0", "b", "0", "0", "3"],
    ["0", "0", "0", "b", "0", "0", "0", "0", "0", "0", "0", "b", "0", "0", "0"],
    ["0", "0", "0", "b", "0", "0", "0", "0", "0", "0", "0", "b", "0", "0", "0"],
    ["b", "b", "b", "b", "0", "0", "0", "0", "0", "0", "0", "b", "b", "b", "b"],
    ["0", "0", "0", "0", "0", "0", "0", "0", "0", "0", "0", "0", "0", "0", "0"],
    ["0", "0", "0", "0", "0", "0", "0", "0", "0", "0", "0", "0", "0", "0", "0"],
    ["0", "0", "0", "0", "0", "0", "1", "1", "1", "0", "0", "0", "0", "0", "0"],
    ["0", "0", "0", "0", "0", "0", "1", "1", "1", "0", "0", "0", "0", "0", "0"],
    ["0", "0", "0", "0", "0", "0", "1", "1", "1", "0", "0", "0", "0", "0", "0"],
    ["0", "0", "0", "0", "0", "0", "0", "0", "0", "0", "0", "0", "0", "0", "0"],
    ["0", "0", "0", "0", "0", "0", "0", "0", "0", "0", "0", "0", "0", "0", "0"],
    ["b", "b", "b", "b", "0", "0", "0", "0", "0", "0", "0", "b", "b", "b", "b"],
    ["0", "0", "0", "b", "0", "0", "0", "0", "0", "0", "0", "b", "0", "0", "0"],
    ["0", "0", "0", "b", "0", "0", "0", "0", "0", "0", "0", "b", "0", "0", "0"],
    ["3", "0", "0", "b", "0", "0", "0", "0", "0", "0", "0", "b", "0", "0", "3"]],
 "goal": {
    "mercury": 5,
    "saturn": 5,
    "jupiter": 5,
    "moon": 5
    }
}
