{
 "name": "Level 3",
 "elements": [
    "1",
    "2",
    "3",
    "4"
    ],
 "spoilt": [
    "1",
    "2"
    ],
 "locked": [
    "4"
    ],
 "figure_max_size": 4,
 "bg_image": "bg1.jpg",
 "field": 
    [["1", "1", "0", "0", "0", "0", "0", "0", "0", "0", "0", "0", "0", "4", "4"],
    ["1", "1", "0", "0", "0", "0", "0", "0", "0", "0", "0", "0", "0", "4", "4"],
    ["2", "2", "0", "0", "0", "0", "0", "0", "0", "0", "0", "0", "0", "3", "3"],
    ["2", "2", "0", "0", "0", "0", "0", "0", "0", "0", "0", "0", "0", "3", "3"],
    ["0", "0", "0", "0", "0", "0", "0", "0", "0", "0", "0", "0", "0", "0", "0"],
    ["0", "0", "0", "0", "0", "0", "0", "0", "0", "0", "0", "0", "0", "0", "0"],
    ["0", "0", "0", "0", "0", "0", "0", "0", "0", "0", "0", "0", "0", "0", "0"],
    ["0", "0", "0", "0", "0", "0", "0", "0", "0", "0", "0", "0", "0", "0", "0"],
    ["0", "0", "0", "0", "0", "0", "0", "0", "0", "0", "0", "0", "0", "0", "0"],
    ["0", "0", "0", "0", "0", "0", "0", "0", "0", "0", "0", "0", "0", "0", "0"],
    ["0", "0", "0", "0", "0", "0", "0", "0", "0", "0", "0", "0", "0", "0", "0"],
    ["3", "3", "0", "0", "0", "0", "0", "0", "0", "0", "0", "0", "0", "2", "2"],
    ["3", "3", "0", "0", "0", "0", "0", "0", "0", "0", "0", "0", "0", "2", "2"],
    ["4", "4", "0", "0", "0", "0", "0", "0", "0", "0", "0", "0", "0", "1", "1"],
    ["4", "4", "0", "0", "0", "0", "0", "0", "0", "0", "0", "0", "0", "1", "1"]],
 "goal": {
    "1": 5,
    "2": 5,
    "3": 5,
    "4": 5
    }
}
