{
 "name": "Level 5",
 "elements": [
    "1",
    "2",
    "3",
    "4"
    ],
 "spoilt": [],
 "locked": [],
 "figure_max_size": 4,
 "bg_image": "bg1.jpg",
 "grid_border": "grid_border.png",
 "field": 
    [["4", "3", "4", "0", "0", "0", "0", "o", "0", "0", "0", "0", "4", "3", "4"],
    ["3", "4", "0", "0", "0", "0", "0", "0", "0", "0", "0", "0", "0", "4", "3"],
    ["4", "0", "b", "b", "b", "0", "0", "o", "0", "0", "b", "b", "b", "0", "4"],
    ["0", "0", "b", "e", "b", "0", "0", "0", "0", "0", "b", "e", "b", "0", "0"],
    ["0", "0", "b", "b", "b", "0", "0", "o", "0", "0", "b", "b", "b", "0", "0"],
    ["0", "0", "0", "0", "0", "1", "1", "0", "1", "1", "0", "0", "0", "0", "0"],
    ["0", "0", "0", "0", "0", "1", "1", "o", "1", "1", "0", "0", "0", "0", "0"],
    ["o", "0", "o", "0", "o", "0", "o", "0", "o", "0", "o", "0", "o", "0", "o"],
    ["0", "0", "0", "0", "0", "1", "1", "o", "1", "1", "0", "0", "0", "0", "0"],
    ["0", "0", "0", "0", "0", "1", "1", "0", "1", "1", "0", "0", "0", "0", "0"],
    ["0", "0", "b", "b", "b", "0", "0", "o", "0", "0", "b", "b", "b", "0", "0"],
    ["0", "0", "b", "e", "b", "0", "0", "0", "0", "0", "b", "e", "b", "0", "0"],
    ["4", "0", "b", "b", "b", "0", "0", "o", "0", "0", "b", "b", "b", "0", "4"],
    ["3", "4", "0", "0", "0", "0", "0", "0", "0", "0", "0", "0", "0", "4", "3"],
    ["4", "3", "4", "0", "0", "0", "0", "o", "0", "0", "0", "0", "4", "3", "4"]],
 "goal": {
    "1": 15,
    "2": 15,
    "3": 15
    }
}
